SCREENSIZE 9 18
PLAYERMINYPOS 20 
0  0  0  33 33 33 0  0  0 
0  0  0  33 23 33 0  0  0 
0  0  0  33 33 33 0  0  0 
31 31 31 0  0  0  31 31 31
31 22 31 0  0  0  31 22 31
31 31 31 0  0  0  31 31 31
43 43 43 43 43 43 43 43 43
41 41 41 41 41 41 41 41 41