SCREENSIZE 8 17
PLAYERMINYPOS 200
75 75 15 75 75 15 75 75 
15 25 21 21 21 21 25 15 
15 45 45 45 45 45 45 15 
15 33 33 33 33 33 33 15
75 62 62 62 62 62 62 75 
62 75 15 15 15 15 75 62
73 62 44 44 44 44 62 73 
73 35 44 45 45 44 35 73
73 13 13 73 73 13 13 73