SCREENSIZE 9 18
PLAYERMINYPOS 240
00 00 00 00 00 00 00 00 00
00 33 00 00 00 00 00 33 00
00 33 00 00 00 00 00 33 00
00 33 33 00 00 00 33 33 00
00 33 33 33 33 33 33 33 00
00 33 33 33 33 33 33 33 00
00 33 33 25 33 25 33 33 00
00 33 33 25 33 25 33 33 00
00 00 33 33 33 33 33 00 00
00 00 33 33 33 33 33 00 00
00 00 33 61 61 61 33 00 00
00 00 33 71 71 71 33 00 00
00 00 33 33 33 33 33 00 00
00 00 00 33 33 33 00 00 00