SCREENSIZE 9 18
PLAYERMINYPOS 20 
22 22 22 22 22 22 22 22 22
22 22 22 22 22 22 22 22 22
22 22 22 22 22 22 22 22 22
22 22 22 22 22 22 22 22 22
33 33 33 33 33 33 33 33 33
43 43 43 43 43 43 43 43 43
43 43 43 43 43 43 43 43 43