SCREENSIZE 12 15
PLAYERMINYPOS
FULLSCREEN 1
24 24 24 24 24 24 24 24 24 24 24 24
44 44 44 44 44 44 44 44 44 44 44 44
70 70 70 70 70 70 70 70 70 70 70 70
70 70 70 70 70 70 70 70 70 70 70 70
70 70 70 70 70 70 70 70 70 70 70 70
70 70 70 70 70 70 70 70 70 70 70 70
70 70 70 70 70 70 70 70 70 70 70 70
70 70 70 70 70 70 70 70 70 70 70 70
70 70 70 70 70 70 70 70 70 70 70 70
70 70 70 70 70 70 70 70 70 70 70 70