SCREENSIZE 9 20
PLAYERMINYPOS 370 
00 00 00 00 00 00 00 00 00
00 21 21 00 22 22 00 21 21
00 21 21 00 22 22 00 21 21 
00 00 00 00 00 00 00 00 00
31 31 00 30 30 00 31 31 00
31 31 00 30 30 00 31 31 00 
00 00 00 00 00 00 00 00 00
00 30 30 00 31 31 00 30 30
00 30 30 00 31 31 00 30 30 
00 00 00 00 00 00 00 00 00 
12 12 00 11 11 00 12 12 00
12 12 00 11 11 00 12 12 00
00 00 00 00 00 00 00 00 00
00 11 11 00 12 12 00 11 11
00 11 11 00 12 12 00 11 11 