SCREENSIZE 12 18
PLAYERMINYPOS 0
00 25 35 00 35 00 00 35 00 35 25 00
00 00 35 35 25 35 35 25 35 35 00 00
00 00 00 00 35 00 00 35 00 00 00 00
00 00 00 00 00 00 00 00 00 00 00 00
72 72 72 72 72 72 72 72 72 72 72 72
64 64 64 64 64 64 64 64 64 64 64 64
63 63 63 63 63 65 65 63 63 63 63 63