SCREENSIZE 11 15
PLAYERMINYPOS 210 
10 10 10 10 33 00 33 10 10 10 10
40 40 40 10 10 00 10 10 40 40 40
41 41 40 10 10 00 10 10 40 41 41
20 41 40 10 10 00 10 10 40 41 20
20 41 40 10 33 00 33 10 40 41 20
41 41 40 10 33 00 33 10 40 41 41
40 40 40 10 33 00 33 10 40 40 40
10 10 10 10 33 00 33 10 10 10 10
10 10 10 10 33 00 33 10 10 10 10
33 33 33 33 33 00 33 33 33 33 33