SCREENSIZE 9 15
PLAYERMINYPOS 180 

31 31 00 00 00 00 00 31 31
22 31 00 00 00 00 00 31 22
22 31 00 32 32 32 00 31 22
22 31 00 32 23 32 00 31 22
22 31 00 32 32 32 00 31 22
22 31 00 00 00 00 00 31 22
31 31 00 00 00 00 00 31 31