SCREENSIZE 9 20
PLAYERMINYPOS 200
21 10 21 10 22 10 21 10 21
12 12 12 12 12 12 12 12 12
12 13 12 13 12 13 12 13 12
13 12 13 12 13 12 13 12 13
10 20 10 20 10 20 10 20 10
12 12 12 12 12 12 12 12 12
41 41 41 41 41 41 41 41 41