SCREENSIZE 8 18
PLAYERMINYPOS 200
00 00 00 11 11 00 00 00
00 00 11 12 12 11 00 00
00 11 12 13 13 12 11 00
11 12 13 21 20 13 12 11
11 12 13 20 21 13 12 11
00 11 12 13 13 12 11 00
00 00 11 12 12 11 00 00
00 00 00 11 11 00 00 00