SCREENSIZE 11 18
PLAYERMINYPOS 0
25 21 25 21 25 21 25 21 25 21 25
63 63 63 63 63 63 63 63 63 63 63
75 75 75 75 75 75 75 75 75 75 75
75 75 75 75 75 75 75 75 75 75 75
74 74 74 74 74 74 74 74 74 74 74
73 73 73 73 73 73 73 73 73 73 73
72 72 72 72 72 72 72 72 72 72 72