SCREENSIZE 11 23
PLAYERMINYPOS 330 

21 21 00 21 21 00 21 21 00 21 21
20 20 00 20 20 00 20 20 00 20 20
00 00 00 00 00 00 00 00 00 00 00
41 41 41 41 41 41 41 41 41 41 41
32 32 32 32 32 32 32 32 32 32 32
00 00 00 00 00 00 00 00 00 00 00
32 32 32 32 32 32 32 32 32 32 32
31 31 31 31 31 31 31 31 31 31 31
00 00 00 00 00 00 00 00 00 00 00
12 12 12 12 12 12 12 12 12 12 12
11 11 11 11 11 11 11 11 11 11 11
00 00 00 00 00 00 00 00 00 00 00
11 11 11 11 11 11 11 11 11 11 11
10 10 10 10 10 10 10 10 10 10 10