SCREENSIZE 8 17
PLAYERMINYPOS 200
75 35 45 45 35 15 25 45 
45 14 75 24 64 45 64 15 
65 15 13 23 64 63 63 34 
35 75 34 25 22 62 62 43 
23 75 14 31 13 64 41 24 
32 23 20 41 43 63 22 61 
61 10 21 20 30 43 72 21 
41 32 42 30 10 72 32 61 
30 40 20 20 11 60 31 41 
30 20 20 10 70 10 70 70 
